0,0,0,0,0,0,0,0,0,0,0,
0,0,0,0,1,1,1,0,0,0,0,
0,0,1,1,1,1,1,1,1,0,0,
0,0,1,0,0,0,0,0,1,0,0,
0,1,1,0,0,0,0,0,1,1,0,
0,1,1,0,0,0,0,0,1,1,0,
0,1,1,0,0,0,0,0,1,1,0,
0,0,1,0,0,0,0,0,1,0,0,
0,0,1,1,1,1,1,1,1,0,0,
0,0,0,0,1,1,1,0,0,0,0,
0,0,0,0,0,0,0,0,0,0,0,
t
0,0,0,0,0,0,0,0,0,0,0,
0,0,0,0,229,129,229,0,0,0,0,
0,0,229,129,229,129,129,129,129,0,0,
0,0,129,0,0,0,0,0,129,0,0,
0,229,129,0,0,0,0,0,129,229,0,
0,129,129,0,0,0,0,0,129,129,0,
0,229,129,0,0,0,0,0,129,229,0,
0,0,129,0,0,0,0,0,129,0,0,
0,0,129,129,129,129,129,129,129,0,0,
0,0,0,0,229,129,229,0,0,0,0,
0,0,0,0,0,0,0,0,0,0,0,
o
129.0,2.865154981613159,22.745826721191406,3.0,
129.0,31.123802185058594,14.198179244995117,1.0,
