129,129,129,129,129,129,129,129,129,129,129,129,129,129,129,129,129,129,129,129,129,129,129,
129,0,0,0,0,0,0,0,0,0,0,0,0,0,0,0,0,0,0,0,229,129,129,
129,0,0,0,0,0,0,0,0,0,0,0,0,0,0,0,0,0,0,0,129,129,129,
129,0,0,0,0,0,0,0,0,0,0,0,0,0,0,0,0,0,0,0,129,129,129,
129,0,0,0,0,0,0,0,0,0,0,0,0,0,0,0,129,129,129,0,129,129,129,
129,0,0,0,0,0,0,0,0,0,0,0,0,0,0,0,129,0,0,0,0,129,129,
129,129,129,129,129,129,129,129,129,129,129,129,129,129,129,129,129,129,129,129,129,129,129,
