1,1,1,1,1,1,1,1,1,1,1,
1,0,0,0,0,0,1,1,0,1,1,
1,0,0,0,0,0,1,1,1,1,1,
1,0,0,0,0,0,1,0,0,1,1,
1,0,0,0,0,0,1,1,1,1,1,
1,0,0,0,0,0,1,1,0,1,1,
1,1,1,1,1,1,1,1,1,1,1,
t
129,129,129,129,129,129,129,129,129,129,129,
129,0,0,0,0,0,229,129,0,129,129,
129,0,0,0,0,0,129,129,129,129,129,
129,0,0,0,0,0,129,0,0,129,129,
129,0,0,0,0,0,129,129,129,129,129,
129,0,0,0,0,0,129,129,0,129,129,
129,129,129,129,129,129,129,129,129,129,129,
o
231.0,3.393601894378662,25.096397399902344,
132.0,10.248000144958496,4.424001693725586,1.0,
129.0,3.359999895095825,32.14400100708008,1.0,
129.0,17.219999313354492,31.766000747680664,3.0,
