1,1,1,1,1,1,1,1,1,1,1,1,1,1,1,1,1,
1,0,0,0,0,0,0,0,0,0,0,0,0,0,0,0,1,
1,0,0,0,0,0,0,0,0,0,2,2,2,0,0,0,1,
1,0,0,0,0,0,0,0,0,0,2,0,2,0,0,0,1,
1,0,0,0,0,0,0,0,0,0,2,2,2,0,0,0,1,
1,0,0,0,0,0,0,0,0,0,0,0,0,0,0,0,1,
1,1,1,1,1,1,1,1,1,1,1,1,1,1,1,1,1,
t
131,131,131,131,131,131,131,131,131,131,131,131,131,131,131,131,131,
131,0,0,0,0,0,0,0,0,0,0,0,0,0,0,0,131,
131,0,0,0,0,0,0,0,0,0,132,133,133,0,0,0,131,
131,0,0,0,0,0,0,0,0,0,132,0,133,0,0,0,131,
131,0,0,0,0,0,0,0,0,0,132,133,133,0,0,0,131,
131,0,0,0,0,0,0,0,0,0,0,0,0,0,0,0,131,
131,131,131,131,131,131,131,131,131,131,131,131,131,131,131,131,131,
o
129.0,10.147200584411621,11.958802223205566,3.0,
129.0,10.382400512695312,38.7716007232666,3.0,
230.0,9.382801055908203,46.41559982299805,5.0,
