1,1,1,1,1,1,1,1,1,1,1,1,1,1,1,1,1,
1,0,0,0,0,0,0,0,0,0,0,0,0,0,0,0,1,
1,0,0,0,0,0,0,0,0,0,0,0,0,0,0,0,1,
1,0,0,0,0,0,0,0,0,0,0,0,0,0,0,0,1,
1,0,0,0,0,0,0,0,0,0,0,0,0,0,0,0,1,
1,0,0,0,0,0,0,0,0,0,0,0,0,0,0,0,1,
1,0,0,0,0,0,0,0,0,0,0,0,0,0,0,0,1,
1,0,0,0,0,0,0,0,0,0,0,0,0,0,0,0,1,
1,0,0,0,0,0,0,0,0,0,0,0,0,0,0,0,1,
1,0,0,0,0,0,0,0,0,0,0,0,0,0,0,0,1,
1,1,1,0,1,1,1,1,1,1,1,1,1,1,1,1,1,
1,0,1,0,1,0,0,0,1,0,0,0,1,0,0,0,1,
1,0,1,0,1,0,0,0,1,0,0,0,1,0,1,1,1,
1,0,1,0,1,0,1,0,1,0,1,0,1,0,1,0,1,
1,0,1,0,1,0,1,0,0,0,1,0,1,0,1,1,1,
1,0,1,0,1,0,1,0,0,0,1,0,1,0,0,0,1,
1,1,1,1,1,1,1,1,1,1,1,1,1,1,1,1,1,
t
131,131,131,131,131,131,131,131,131,131,131,131,131,131,131,131,131,
131,0,0,0,0,0,0,0,0,0,0,0,0,0,0,0,131,
131,0,0,0,0,0,0,0,0,0,0,0,0,0,0,0,131,
131,0,0,0,0,0,0,0,0,0,0,0,0,0,0,0,131,
131,0,0,0,0,0,0,0,0,0,0,0,0,0,0,0,131,
131,0,0,0,0,0,0,0,0,0,0,0,0,0,0,0,131,
131,0,0,0,0,0,0,0,0,0,0,0,0,0,0,0,131,
131,0,0,0,0,0,0,0,0,0,0,0,0,0,0,0,131,
131,0,0,0,0,0,0,0,0,0,0,0,0,0,0,0,131,
131,0,0,0,0,0,0,0,0,0,0,0,0,0,0,0,131,
131,131,131,0,131,131,131,131,131,131,131,131,131,131,131,131,131,
131,0,131,0,131,0,0,0,131,0,0,0,140,0,0,0,131,
131,0,131,0,131,0,0,0,131,0,0,0,140,0,140,140,131,
131,0,131,0,131,0,131,0,131,0,131,0,140,0,140,0,131,
131,0,131,0,231,0,131,0,0,0,131,0,140,0,140,140,131,
131,0,131,0,231,0,131,0,0,0,131,0,140,0,0,0,131,
131,131,131,131,131,131,131,131,131,131,131,131,131,131,131,131,131,
o
230.0,10.206000328063965,10.371202230453491,10.0,
129.0,16.673999786376953,10.665202379226685,0.0,
129.0,10.441200256347656,52.76599884033203,3.0,
130.0,3.1408112049102783,38.879241943359375,
130.0,17.414794921875,52.51169967651367,
