1,1,1,1,1,0,0,1,1,
1,0,0,0,1,0,0,0,1,
1,0,1,1,1,0,1,1,1,
1,0,1,0,0,0,1,0,0,
1,0,0,0,0,0,1,0,0,
1,0,0,0,0,0,1,0,1,
1,0,1,1,0,0,0,0,1,
1,0,1,0,0,0,0,0,1,
1,1,1,0,0,1,1,1,1,
t
129,129,129,129,129,0,0,129,129,
129,0,0,0,129,0,0,0,129,
129,0,129,129,129,0,129,129,129,
129,0,129,0,0,0,129,0,0,
129,0,0,0,0,0,129,0,0,
129,0,0,0,0,0,129,0,129,
129,0,129,129,0,0,0,0,129,
129,0,129,0,0,0,0,0,129,
129,129,129,0,0,129,129,129,129,
o
231.0,14.080188751220703,13.946542739868164,
