0,0,0
4,4,4,4,4,4,4,4,4,4,4,4,4,4,4,4,4,4,4,4,4,4,4
4,0,0,0,0,0,0,0,0,0,0,0,0,0,0,0,0,0,0,0,0,0,4
4,0,5,5,0,0,0,0,0,0,0,0,0,0,0,0,0,1,9,0,0,0,4
4,0,4,4,0,0,0,0,0,0,0,0,0,0,0,0,0,2,8,0,0,0,4
4,0,3,3,0,0,0,0,0,0,0,0,0,0,0,0,0,3,7,0,0,0,4
4,0,0,0,0,0,0,0,0,0,0,0,0,0,0,0,0,4,6,0,0,0,4
4,0,0,0,0,0,0,0,0,0,0,0,0,0,0,0,0,5,5,0,0,0,4
4,0,1,1,0,0,0,0,0,0,9,9,0,0,0,0,0,6,4,0,0,0,4
4,0,1,1,0,0,0,0,0,0,900,9,0,0,0,0,0,7,3,0,0,0,4
4,0,1,2,0,0,0,0,0,0,0,0,0,0,0,0,0,8,2,0,0,0,4
4,0,1,2,0,0,0,0,0,0,0,0,0,0,0,0,0,9,1,0,0,0,4
4,0,1,1,0,0,0,0,0,0,0,0,0,0,0,0,0,0,0,0,0,0,4
4,0,1,1,0,0,0,0,0,0,0,0,0,0,0,0,0,0,0,0,0,0,4
4,0,0,0,0,0,0,0,0,0,0,0,0,0,0,0,0,0,0,0,0,0,4
4,4,4,4,4,4,4,4,4,4,4,4,4,4,4,4,4,4,4,4,4,4,4