1,1,1,1,1,1,1,1,1,
1,0,0,0,0,0,0,0,1,
1,0,0,0,0,0,1,0,1,
1,0,0,0,0,0,0,0,1,
1,1,1,0,0,0,1,0,1,
1,0,0,0,0,0,0,0,1,
1,0,1,0,0,0,0,0,1,
1,0,0,0,0,0,0,0,1,
1,1,1,1,1,1,1,1,1,
t
230,232,230,232,230,232,230,232,230,
232,0,0,0,0,0,0,0,232,
230,0,0,0,0,0,229,0,230,
232,0,0,0,0,0,0,0,232,
230,0,229,0,0,0,229,0,230,
232,0,0,0,0,0,0,0,232,
230,0,229,0,0,0,0,0,230,
232,0,0,0,0,0,0,0,232,
230,232,230,232,230,232,230,232,230,
o
129.0,21.24888801574707,13.720000267028809,2.0,
129.0,6.657777786254883,14.124444007873535,3.0,
132.0,14.09333324432373,13.937777519226074,1.0,
