1,1,1,1,1,1,1,1,1,
1,1,0,1,0,1,0,1,1,
1,0,1,0,0,0,1,0,1,
1,1,0,1,0,1,0,1,1,
1,0,1,0,1,0,1,0,1,
1,1,0,1,0,1,0,1,1,
1,0,1,0,0,0,1,0,1,
1,1,0,1,0,1,0,1,1,
1,1,1,1,1,1,1,1,1,
t
235,235,235,235,235,235,235,235,235,
235,129,0,129,0,129,0,129,235,
235,0,130,0,0,0,130,0,235,
235,129,0,129,0,129,0,129,235,
235,0,130,0,130,0,130,0,235,
235,129,0,129,0,129,0,129,235,
235,0,130,0,0,0,130,0,235,
235,129,0,129,0,129,0,129,235,
235,235,235,235,235,235,235,235,235,
o
129.0,21.24888801574707,13.720000267028809,2.0,
129.0,6.657777786254883,14.124444007873535,3.0,
231.0,12.786666870117188,7.062222003936768,
229.0,24.69681167602539,3.886521816253662,
130.0,24.242319107055664,21.2221736907959,
130.0,14.762898445129395,17.131738662719727,
130.0,9.76347827911377,4.8279709815979,
