1,1,1,1,0,0,3,0,1,
0,0,0,0,0,3,0,0,0,
0,0,3,0,3,0,3,0,0,
0,0,0,0,0,3,0,0,0,
1,1,1,1,0,0,3,0,1,
t
139,139,139,139,0,0,135,0,139,
0,0,0,0,0,129,0,0,0,
0,0,135,0,135,0,135,0,0,
0,0,0,0,0,129,0,0,0,
139,139,139,139,0,0,135,0,139,
o
130.0,6.966399669647217,24.707199096679688,
130.0,6.874000072479248,10.317999839782715,
