1,1,1,0,1,0,1,0,0,1,0,1,0,0,1,0,0,
1,1,0,1,0,1,0,1,0,1,0,1,0,1,0,1,1,
1,0,1,0,1,0,1,0,1,0,1,0,1,0,1,0,1,
1,1,0,1,0,1,0,0,0,0,0,0,0,0,0,0,1,
1,0,1,0,1,0,1,0,1,0,1,0,1,0,1,0,1,
1,1,0,1,0,1,0,1,0,1,0,1,0,1,0,1,1,
1,1,0,0,1,0,1,0,1,1,0,1,1,0,1,0,1,
t
129,129,129,0,129,0,129,0,0,129,0,129,0,0,129,0,0,
129,129,0,129,0,129,0,129,0,129,0,129,0,129,0,129,129,
129,0,129,0,129,0,129,0,129,0,129,0,129,0,129,0,229,
129,129,0,129,0,129,0,0,0,0,0,0,0,0,0,0,229,
129,0,129,0,129,0,129,0,129,0,129,0,129,0,129,0,229,
129,129,0,129,0,129,0,129,0,129,0,129,0,129,0,129,129,
129,129,0,0,129,0,129,0,129,129,0,129,129,0,129,0,129,
o
230.0,10.6343994140625,51.96799850463867,15.0,
