0,0,0,0,0,0,0,0,0,0,0,0,0,0,0,
0,0,0,0,0,0,0,0,0,0,0,0,0,0,0,
0,0,1,1,1,1,1,1,1,1,1,1,1,0,0,
0,0,1,0,0,0,0,0,0,0,0,0,1,0,0,
0,0,1,0,0,0,1,1,1,0,0,0,1,0,0,
0,0,1,0,0,0,0,0,1,0,0,0,1,0,0,
0,0,1,0,1,0,1,1,1,1,0,0,1,0,0,
0,0,1,0,1,0,1,0,0,0,0,0,1,0,0,
0,0,1,0,0,0,1,1,0,0,0,0,1,0,0,
0,0,1,0,0,0,1,0,0,0,0,0,1,0,0,
0,0,1,0,0,0,0,0,0,0,0,0,1,0,0,
0,0,1,0,0,0,0,0,0,0,0,0,1,0,0,
0,0,1,1,1,1,1,1,1,1,1,1,1,0,0,
0,0,0,0,0,0,0,0,0,0,0,0,0,0,0,
0,0,0,0,0,0,0,0,0,0,0,0,0,0,0,
t
0,0,0,0,0,0,0,0,0,0,0,0,0,0,0,
0,0,0,0,0,0,0,0,0,0,0,0,0,0,0,
0,0,129,129,129,129,129,129,129,129,129,129,129,0,0,
0,0,129,0,0,0,0,0,0,0,0,0,129,0,0,
0,0,129,0,0,0,229,229,229,0,0,0,129,0,0,
0,0,129,0,0,0,0,0,229,0,0,0,129,0,0,
0,0,129,0,229,0,229,229,229,229,0,0,129,0,0,
0,0,129,0,229,0,229,0,0,0,0,0,129,0,0,
0,0,129,0,0,0,229,229,0,0,0,0,129,0,0,
0,0,129,0,0,0,229,0,0,0,0,0,129,0,0,
0,0,129,0,0,0,0,0,0,0,0,0,129,0,0,
0,0,129,0,0,0,0,0,0,0,0,0,129,0,0,
0,0,129,129,129,129,129,129,129,129,129,129,129,0,0,
0,0,0,0,0,0,0,0,0,0,0,0,0,0,0,
0,0,0,0,0,0,0,0,0,0,0,0,0,0,0,
o
129.0,3.0990450382232666,25.10811996459961,3.0,
129.0,45.33961868286133,22.0909366607666,1.0,
230.0,34.20595169067383,2.214878559112549,1.0,
131.0,27.60364532470703,2.94846773147583,
132.0,15.584068298339844,1.9891588687896729,0.0,
231.0,46.902687072753906,4.754225730895996,
