0,0,0,0,0,0,0,0,0,0,0,
0,0,0,0,0,0,0,0,0,0,0,
0,0,1,1,1,1,1,1,1,0,0,
0,0,1,0,0,0,0,0,1,0,0,
0,0,1,0,0,0,0,0,1,0,0,
0,0,1,0,0,0,0,0,1,0,0,
0,0,1,0,0,0,0,0,1,0,0,
0,0,1,0,0,0,0,0,1,0,0,
0,0,1,1,1,1,1,1,1,0,0,
0,0,0,0,0,0,0,0,0,0,0,
0,0,0,0,0,0,0,0,0,0,0,
t
0,0,0,0,0,0,0,0,0,0,0,
0,0,0,0,0,0,0,0,0,0,0,
0,0,129,129,129,129,129,129,129,0,0,
0,0,129,0,0,0,0,0,129,0,0,
0,0,129,0,0,0,0,0,129,0,0,
0,0,129,0,0,0,0,0,129,0,0,
0,0,129,0,0,0,0,0,129,0,0,
0,0,129,0,0,0,0,0,129,0,0,
0,0,129,129,129,129,129,129,129,0,0,
0,0,0,0,0,0,0,0,0,0,0,
0,0,0,0,0,0,0,0,0,0,0,
o
129.0,31.433176040649414,14.676614761352539,1.0,
129.0,2.865154981613159,22.745826721191406,3.0,
